20 20
####################
#   X         S   ##
#####  #### # #   ##
##  #     # # #   ##
##  ####  # # #   ##
##  #     ### ### ##
##     ###       G##
######  ## #########
#######    #########
####################
####################
####################
####################
####################
####################
####################
####################
####################
####################
####################