20 20
####################
#                  #
#    X             #
#                  #
#                  #
#                  #
#                  #
#                  #
#                  #
#                  #
#                  #
#                  #
#                  #
#                  #
#                  #
#              G   #
#                  #
#                  #
#                  #
####################
