8 8
########
#      #
#  # # #
#### # #
#      #
# ### ##
#  G   #
########