10 10
##########
#        #
#  # # # #
#### # # #
#      # #
# ### ## #
# #   #  #
# ## ## ##
# #      #
##########